120
80
20
000001000000000000000000000000000000000000000000000000000000000111100000000000000000000000000000000000000000000000000000
000001000000000000000000000000000000000000000000000000000000000111111000000000000000000000000000000000000000000000000000
000000110000000000000000000000000000000000000000000000000000000111111111000000000000000000000000000000000000000000000000
000000001100000000000000000000000000000000000000000000000000000111111111100000000000000000000000000000000000000000000000
000000000011000000000000000000000000000000000000000000000000000111111111100000000000000000000000000000000000000000000000
000000000000100000000000000000000000000000000000000000000000000011111111110000000000000000000000000000000000000000000000
000000000000010000000000000000000000000000000000000000000000000001111111110000000000000000000000000000000000000000000000
000000000000010000000000000000000000000000000000000000000000000000011111100000000000000000000000000000000000000000000000
000000000000010000000000000000000000000000000000000000000000000000000000000000000000000000000000000000000000000000000000
000000000000001100000000000000000000000000000000000000000000000000000000000000000000000000000000000000000000000000000000
000000000000000010000000000000000000000000000000000000000000000000000000000000000000000000000000000000000000000000000000
000000000000000001000000000000000000000000000000000000000000000000000000000000000000000000000000000000000000000000000000
000000000000000000100000000000000000000000000000000000000000000000000000000000000000000000000000000000000000000000000000
000000000000000000000000000000000000000000000000000000000000000000000000000000000000000000000000000000000000000000000000
000000000001111111110000000000000000000000000000000000000000000000000000000000000000000000000000000000000000000000000000
000000000010000000010000000000000000000000000000000000000000000000000000000000000000000000000000000000000000000000000000
000000000100000000010000000000000000000000000000000000000000000000000000000000000000000000000000000000000000000000000000
000000001000000000100000000000000000000000000000000000000000000000000000000000000000000000000000000000000000000000000000
000000010000000001000000000000000000000000000000000000000000000000000000000000000000000000000000000000000000000000000000
000000100000000010000000000000000000000000000000000000000000000000000000000000000000000000000000000000000000000000000000
111111000000000100000000000000000000000000000000000000000000000000000000000000000000000000000000000000000000000000000000
000000000000000011100000000000000000000000000000000000000000000000000000000000000000000000000000000000000000000000000000
000000000000000000010000000000000000000000000000000000000000000000000000000000000000000000000000000000000000000000000000
000000000000000000001100000000000000000000000000000000000000000000000000000000000000000000000000000000000000000000000000
000000000000000000000010000000000000000000000000000000000000000000000000000000000000000000000000000000000000000000000000
000000000000000000000010000000000000000000000000000000000000000000000000000000000000000000000000000000000000000000000000
000000000000000000000001000000000000000000000000000000000000000000000000000000000000000000000000000000000000000000000000
000000000000000000000001000000000000000000000000000000000000000000000000000000000000000000000000000000000000000000000000
000000000000000000000001000000000000000000000000000000000000000000000000000000000000000000000000000000000000000000000000
000000000000000000000001000000000000000000000000000000000000000000000000000000000000000000000000000000000000000000000000
000000000000000000000010000000000000000000000000000000000000000000000000000000000000000000000000000000000000000000000000
000000000000000000011000000000000000000000000000000000000000000000000000000000000000000000000000000000000000000000000000
000000000000000001100000000000000000000000000000000000000000000000000000000000000000000000000000000000000000000000000000
000000000000111110000000000000000000000000000000000000000000000000000000000000000000000000000000000000000000000000000000
000000000011000000000000000000000000000000000000000000000000000000000000000000000000000000000000000000000000000000000000
000000011000000000000000000000000000000000000000000000000111111111000000000000000000000000000000000000000000000000000000
000001100000000000000000000000000000000000000000000000011111111111100000000000000000000000000000000000000000000000000000
000010000000000000000000000000000000000000000000000000011111111111110000000000000000000000000000000000000000000000000000
001100000000000000000000000000000000000000000000000000011111111111110000000000000000000000000000000000000000000000000000
010000000000000000000000000000000000000000000000000000011111111111100000000000000000000000000000000000000000000000000000
100000000000000000000000000000000000000000000000000000001111111111100000000000000000000000000000000000000000000000000000
000000000000000000000000000000000000000000000000000000001111111111000000000000000000000000000000000000000000000000000000
000000000000000000000000000000000000000000000000000000000111111111100000000000000000000000000000000000000000000000000000
000000000000000000000000000000000000000000000000000000000011111111110000000000000000000000000000000000000000000000000000
000000000000000000000000000000000000000000000000000000000011111111110000000000000000000000000000000000000000000000000000
000000000000000000000000000000000000000000000000000000000001111111111100000000000000000000000000000000000000000000000000
000000000000000000000000000000000000000000000000000000000000111111111111110000000000000000000000000000000000000000000000
000000000000000000000000000000000000000000000000000000000000011111111111111000000000000000000000000000000000000000000000
000000000000000000000000000000000000000000000000000000000000001111111111111100000000000000000000000000000000000000000000
000000000000000000000000000000000000000000000000000000000000000111111111111110000000000000000000000000000000000000000000
000000000000000000000000000000000000000000000000000000000000000011111111111111000000000000000000000000000000000000000000
000000000000000000000000000000000000000000000000000000000000000000111111111111000000000000000000000000000000000000000000
000000000000000000000000000000000000000000000000000000000000000000011111111111100000000000000000000000000000000000000000
000000000000000000000000000000000000000000000000000000000000000000001111111111100000000000000000000000000000000000000000
000000000000000000000000000000000000000000011100000000000000000000001111111111100000000000000000000000000000000000000000
000000000000000000000000000000000000000000011110000000000000000000001111111111100000000000000000000000000000000000000000
000000000000000000000000000000000000000000011111000000000000000000001111111111100000000000000000000000000000000000000000
000000000000000000000000000000000000000000111111100000000000000000001111111111000000000000000000000000000000000000000000
000000000000000000000000000000000000000000111111100000000000000000001111111111000000000000000000000000000000000000000000
000000000000000000000000000000000000000000111111110000000000000000001111111110000000000000000000000000000000000000000000
000000000000000000000000000000000000000000011111110000000000000000001111111110000000000000000000000000000000000000000000
000000000000000000000000000000000000000000011111111000000000000000001111111110000000000000000000000000000000000000000000
000000000000000000000000000000000000000000011111111000000000000000001111111100000000000000000000000000000000000000000000
000000000000000000000000000000000000000000011111111100000000000000001111111100000000000000000000000000000000000000000000
000000000000000000000000000000000000000000011111111111110000000000001111111000000000000000000000000000000000000000000000
000000000000000000000000000000000000000000001111111111111111111111101111110000000000000000000000000000000000000000000000
000000000000000000000000000000000000000000001111111111111111111111111111100000000000000000000000000000000000000000000000
000000000000000000000000000000000000000000000111111111111111111111111111100000000000000000000000000000000000000000000000
000000000000000000000000000000000000000000000111111111111111111111111111000000000000000000000000000000000000000000000000
000000000000000000000000000000000000000000000011111111111111111111111110000000000000000000000000000000000000000000000000
000000000000000000000000000000000000000000000001111111111111111111111100000000000000000000000000000000000000000000000000
000000000000000000000000000000000000000000000001111111111111111111111100000000000000000000000000000000000000000000000000
000000000000000000000000000000000000000000000000111111111111111111111100000000000000000000000000000000000000000000000000
000000000000000000000000000000000000000000000000111111111111111111111000000000000000000000000000000000000000000000000000
000000000000000000000000000000000000000000000000011111111111111111100000000000000000000000000000000000000000000000000000
000000000000000000000000000000000000000000000000001111111111111111000000000000000000000000000000000000000000000000000000
000000000000000000000000000000000000000000000000000111111111111110000000000000000000000000000000000000000000000000000000
000000000000000000000000000000000000000000000000000011111111111110000000000000000000000000000000000000000000000000000000
000000000000000000000000000000000000000000000000000000111111111000000000000000000000000000000000000000000000000000000000
000000000000000000000000000000000000000000000000000000011111000000000000000000000000000000000000000000000000000000000000